...#....##
..###.....
......#.#.
#.........
...##..##.
...#......
.#........
..........
.....##...
.##...#...
