..##...#..
.......#..
..##......
...#......
.....###..
......#...
#.#.......
#.....##..
#.#.......
....#....#
