..#.......
..#......#
....#...##
#..###....
#.........
....#.....
........#.
.....#....
#.........
##.#.##...
