...#......
..###....#
..........
#...##....
........#.
......#...
.....##..#
#..#.....#
#..#..#..#
..........
