..........
.#........
....#.##.#
.........#
...#......
...#......
...##...#.
..........
#.##.....#
#..#.#..##
